Alx3	RRNRTTFSTFQLEELEKVFQKTHYPDVYAREQLALRTDLTEARVQVWFQNRRAKWRK
Alx4	RRNRTTFTSYQLEELEKVFQKTHYPDVYAREQLAMRTDLTEARVQVWFQNRRAKWRK
Arx	RRYRTTFTSYQLEELERAFQKTHYPDVFTREELAMRLDLTEARVQVWFQNRRAKWRK
Bapx1	KRSRAAFSHAQVFELERRFNHQRYLSGPERADLAASLKLTETQVKIWFQNRRYKTKR
Barhl1	RKARTAFTDHQLAQLERSFERQKYLSVQDRMELAASLNLTDTQVKTWYQNRRTKWKR
Barhl2	RKARTAFSDHQLNQLERSFERQKYLSVQDRMDLAAALNLTDTQVKTWYQNRRTKWKR
Barx1	RRSRTVFTELQLMGLEKRFEKQKYLSTPDRIDLAESLGLSQLQVKTWYQNRRMKWKK
Barx2	RRSRTIFTELQLMGLEKKFQKQKYLSTPDRLDLAQSLGLTQLQVKTWYQNRRMKWKK
Bsx	RKARTVFSDSQLSGLEKRFEIQRYLSTPERVELATALSLSETQVKTWFQNRRMKHKK
Cart1	RRHRTTFTSLQLEELEKVFQKTHYPDVYVREQLALRTELTEARVQVWFQNRRAKWRK
Cdx2	DKYRVVYTDHQRLELEKEFHFSRYITIRRKSELAATLGLSERQVKIWFQNRRAKERK
Dobox4	RKKRNMPSIEQKLVLKEHFDESKYLNKEQCKSLAQKLGMKEKQIKTHFKNKRARERR
Cphx	SKPRHKFSRDELKRLKQEFAYAPYPDFTTKDELARQFQCEVSVIDNWFQNKRARLAP
Cutl1	KKPRVVLAPEEKEALKRAYQQKPYPSPKTIEELATQLNLKTSTVINWFHNYRSRIRR
Dbx1	MLRRAVFSDVQRKALEKTFQKQKYISKPDRKKLASKLGLKDSQVKIWFQNRRMKWRN
Dbx2	ILRRAVFSEEQRKALEKMFQKQKYISKTDRRKLAVSLGLKESQVKIWFQNRRMKWRN
Dlx1	RKPRTIYSSLQLQALNRRFQQTQYLALPERAELAASLGLTQTQVKIWFQNKRSKFKK
Dlx2	RKPRTIYSSFQLAALQRRFQKTQYLALPERAELAASLGLTQTQVKIWFQNRRSKFKK
Dlx3	RKPRTIYSSYQLAALQRRFQKAQYLALPERAELAAQLGLTQTQVKIWFQNRRSKFKK
Dlx4	RKPRTIYSSLQLQHLDQRFQHTQYLALPERAQLAAQLGLTQTQVKIWFQNKRSKYKK
Dlx5	RKPRTIYSSFQLAALQRRFQKTQYLALPERAELAASLGLTQTQVKIWFQNKRSKIKK
Dmbx1	RRSRTAFTAQQLEALEKTFQKTHYPDVVMRERLAMCTNLPEARVQVWFKNRRAKFRK
Emx2	KRIRTAFSPSQLLRLEHAFEKNHYVVGAERKQLAHSLSLTETQVKVWFQNRRTKFKR
En1	KRPRTAFTAEQLQRLKAEFQANRYITEQRRQTLAQELSLNESQIKIWFQNKRAKIKK
En2	KRPRTAFTAEQLQRLKAEFQTNRYLTEQRRQSLAQELSLNESQIKIWFQNKRAKIKK
Dobox5	RKQHTVYSKEQQHLLKEHFKECQYPNEKKIVELAVLVGVTKMEIKIWMNLQNIKQAL
Esx1	RRYRICFTPIQLQELEAFFQRVQYPDLFARVELARRLGLPEPRVQVWFQNRRAKWRR
Evx1	RRYRTAFTREQIARLEKEFYRENYVSRPRRCELAAALNLPETTIKVWFQNRRMKDKR
Evx2	RRYRTAFTREQIARLEKEFYRENYVSRPRRCELAAALNLPETTIKVWFQNRRMKDKR
Gbx1	RRRRTAFTSEQLLELEKEFHCKKYLSLTERSQIAHALKLSEVQVKIWFQNRRAKWKR
Gbx2	RRRRTAFTSEQLLELEKEFHCKKYLSLTERSQIAHALKLSEVQVKIWFQNRRAKWKR
Gsc	RRHRTIFTDEQLEALENLFQETKYPDVGTREQLARKVHLREEKVEVWFKNRRAKWRR
Gsh2	KRMRTAFTSTQLLELEREFSSNMYLSRLRRIEIATYLNLSEKQVKIWFQNRRVKHKK
Hdx	KRALQDRTQFSDRDLATLKKYWDNGMTSLGSVCREKIEAVAIELNVDCEIVRTWIGNRRRKYRL
Hlx1	RSWSRAVFSNLQRKGLEKRFEIQKYVTKPDRKQLAAMLGLTDAQVKVWFQNRRMKWRH
Hlxb9	RRPRTAFTSQQLLELEHQFKLNKYLSRPKRFEVATSLMLTETQVKIWFQNRRMKWKR
Hmbox1	RGSRFTWRKECLAVMESYFNENQYPDEAKREEIANACNAVIQKPGKKLSDLERVTSLKVYNWFANRRKEIKR
Hmx1	KKTRTVFSRSQVFQLESTFDLKRYLSSAERAGLAASLQLTETQVKIWFQNRRNKWKR
Hmx2	KKTRTVFSRSQVYQLESTFDMKRYLSSSERACLASSLQLTETQVKTWFQNRRNKWKR
Hmx3	KKTRTVFSRSQVFQLESTFDMKRYLSSSERAGLAASLHLTETQVKIWFQNRRNKWKR
Homez	KTKRKTKEQLAILKSFFLQCQWARREDYHKLEQITGLPRPEIIQWFGDTRYALKHKR
Hoxa1	NAVRTNFTTKQLTELEKEFHFNKYLTRARRVEIAASLQLNETQVKIWFQNRRMKQKK
Hoxa10	RKKRCPYTKHQTLELEKEFLFNMYLTRERRLEISRSVHLTDRQVKIWFQNRRMKLKK
Hoxa11	RKKRCPYTKYQIRELEREFFFSVYINKEKRLQLSRMLNLTDRQVKIWFQNRRMKEKK
Hoxa13	RKKRVPYTKVQLKELEREYATNKFITKDKRRRISATTNLSERQVTIWFQNRRVKEKK
Hoxa2	RRLRTAYTNTQLLELEKEFHFNKYLCRPRRVEIAALLDLTERQVKVWFQNRRMKHKR
Hoxa3	KRARTAYTSAQLVELEKEFHFNRYLCRPRRVEMANLLNLTERQIKIWFQNRRMKYKK
Hoxa4	KRSRTAYTRQQVLELEKEFHFNRYLTRRRRIEIAHTLCLSERQVKIWFQNRRMKWKK
Hoxa5	KRARTAYTRYQTLELEKEFHFNRYLTRRRRIEIAHALCLSERQIKIWFQNRRMKWKK
Hoxa6	RRGRQTYTRYQTLELEKEFHFNRYLTRRRRIEIANALCLTERQIKIWFQNRRMKWKK
Hoxa7	KRGRQTYTRYQTLELEKEFHFNRYLTRRRRIEIAHALCLTERQIKIWFQNRRMKWKK
Hoxa9	RKKRCPYTKHQTLELEKEFLFNMYLTRDRRYEVARLLNLTERQVKIWFQNRRMKMKK
Hoxb13	RKKRIPYSKGQLRELEREYAANKFITKDKRRKISAATSLSERQITIWFQNRRVKEKK
Hoxb3	KRARTAYTSAQLVELEKEFHFNRYLCRPRRVEMANLLNLSERQIKIWFQNRRMKYKK
Hoxb4	KRSRTAYTRQQVLELEKEFHYNRYLTRRRRVEIAHALCLSERQIKIWFQNRRMKWKK
Hoxb5	KRARTAYTRYQTLELEKEFHFNRYLTRRRRIEIAHALCLSERQIKIWFQNRRMKWKK
Hoxb6	RRGRQTYTRYQTLELEKEFHYNRYLTRRRRIEIAHALCLTERQIKIWFQNRRMKWKK
Hoxb7	KRGRQTYTRYQTLELEKEFHYNRYLTRRRRIEIAHTLCLTERQIKIWFQNRRMKWKK
Hoxb8	RRGRQTYSRYQTLELEKEFLFNPYLTRKRRIEVSHALGLTERQVKIWFQNRRMKWKK
Hoxb9	RKKRCPYTKYQTLELEKEFLFNMYLTRDRRHEVARLLNLSERQVKIWFQNRRMKMKK
Hoxc10	RKKRCPYTKHQTLELEKEFLFNMYLTRERRLEISKTINLTDRQVKIWFQNRRMKLKK
Hoxc11	RKKRCPYSKFQIRELEREFFFNVYINKEKRLQLSRMLNLTDRQVKIWFQNRRMKEKK
Hoxc12	RKKRKPYSKLQLAELEGEFLVNEFITRQRRRELSDRLNLSDQQVKIWFQNRRMKKKR
Hoxc4	KRSRTAYTRQQVLELEKEFHYNRYLTRRRRIEIAHSLCLSERQIKIWFQNRRMKWKK
Hoxc5	KRSRTSYTRYQTLELEKEFHFNRYLTRRRRIEIANNLCLNERQIKIWFQNRRMKWKK
Hoxc6	RRGRQIYSRYQTLELEKEFHFNRYLTRRRRIEIANALCLTERQIKIWFQNRRMKWKK
Hoxc8	RSGRQTYSRYQTLELEKEFLFNPYLTRKRRIEVSHALGLTERQVKIWFQNRRMKWKK
Hoxc9	RKRRCPYTKYQTLELEKEFLFNMYLTRDRRYEVARVLNLTERQVKIWFQNRRMKMKK
Hoxd1	SAIRTNFSTKQLTELEKEFHFNKYLTRARRIEIANCLQLNDTQVKIWFQNRRMKQKK
Hoxd11	RKKRCPYTKYQIRELEREFFFNVYINKEKRLQLSRMLNLTDRQVKIWFQNRRMKEKK
Hoxd12	RKKRKPYTKQQIAELENEFLVNEFINRQKRKELSNRLNLSDQQVKIWFQNRRMKKKR
Hoxd13	RKKRVPYTKLQLKELENEYAINKFINKDKRRRISAATNLSERQVTIWFQNRRVKDKK
Hoxd3	KRVRTAYTSAQLVELEKEFHFNRYLCRPRRVEMANLLNLTERQIKIWFQNRRMKYKK
Hoxd8	RRGRQTYSRFQTLELEKEFLFNPYLTRKRRIEVSHTLALTERQVKIWFQNRRMKWKK
Ipf1	KRTRTAYTRAQLLELEKEFLFNKYISRPRRVELAVMLNLTERHIKIWFQNRRMKWKK
Irx2	PAYRKNATRDATATLKAWLNEHRKNPYPTKGEKIMLAIITKMTLTQVSTWFANARRRLKK
Irx3	PKNATRESTSTLKAWLNEHRKNPYPTKGEKIMLAIITKMTLTQVSTWFANARRRLKK
Irx4	RKNATRETTSTLKAWLQEHRKNPYPTKGEKIMLAIITKMTLTQVSTWFANARRRLKK
Irx5	PAYRKNATRDATATLKAWLNEHRKNPYPTKGEKIMLAIITKMTLTQVSTWFANARRRLKK
Irx6	RKNATRESTSALKAWLHEHRKNPYPTKGEKIMLAIITKMTLTQVSTWFANARRRLKK
Isl2	TRVRTVLNEKQLHTLRTCYAANPRPDALMKEQLVEMTGLSPRVIRVWFQNKRCKDKK
Isx	RRVRTTFTTEQLQELEKLFHFTHYPDIHVRSQLASRINLPEARVQIWFQNQRAKWRK
Lhx1	RGPRTTIKAKQLETLKAAFAATPKPTRHIREQLAQETGLNMRVIQVWFQNRRSKERR
Lhx2	KRMRTSFKHHQLRTMKSYFAINHNPDAKDLKQLAQKTGLTKRVLQVWFQNARAKFRR
Lhx3	KRPRTTITAKQLETLKSAYNTSPKPARHVREQLSSETGLDMRVVQVWFQNRRAKEKR
Lhx4	KRPRTTITAKQLETLKNAYKNSPKPARHVREQLSSETGLDMRVVQVWFQNRRAKEKR
Lhx5	RGPRTTIKAKQLETLKAAFAATPKPTRHIREQLAQETGLNMRVIQVWFQNRRSKERR
Lhx6	KRARTSFTAEQLQVMQAQFAQDNNPDAQTLQKLADMTGLSRRVIQVWFQNCRARHKK
Lhx8	KRARTSFTADQLQVMQAQFAQDNNPDAQTLQKLAERTGLSRRVIQVWFQNCRARHKK
Lhx9	KRMRTSFKHHQLRTMKSYFAINHNPDAKDLKQLAQKTGLTKRVLQVWFQNARAKFRR
Lmx1a	KRPRTILTTQQRRAFKASFEVSSKPCRKVRETLAAETGLSVRVVQVWFQNQRAKMKK
Lmx1b	KRPRTILTTQQRRAFKASFEVSSKPCRKVRETLAAETGLSVRVVQVWFQNQRAKMKK
Meis1	HKKRGIFPKVATNIMRAWLFQHLTHPYPSEEQKKQLAQDTGLTILQVNNWFINARRRIVQ
Meox1	RKERTAFTKEQLRELEAEFAHHNYLTRLRRYEIAVNLDLSERQVKVWFQNRRMKWKR
Mrg1	QKKRGIFPKVATNIMRAWLFQHLTHPYPSEEQKKQLAQDTGLTILQVNNWFINARRRIVQ
Mrg2	NKKRGIFPKVATNIMRAWLFQHLSHPYPSEEQKKQLAQDTGLTILQVNNWFINARRRIVQ
Msx1	RKPRTPFTTAQLLALERKFRQKQYLSIAERAEFSSSLSLTETQVKIWFQNRRAKAKR
Msx2	RKPRTPFTTSQLLALERKFRQKQYLSIAERAEFSSSLNLTETQVKIWFQNRRAKAKR
Msx3	RKPRTPFTTAQLLALERKFHQKQYLSIAERAEFSSSLSLTETQVKIWFQNRRAKAKR
Obox1	RKERTVYTKEQQGLLQKHFDECQYPNKKKIVELALSVGVTKREIKIWFKNNRAKYRR
Obox2	RKERTVYTKEEQGLLQKHFDECQYPNKKKIVELALSVGVTKREIKIWFKNNRAKYRQ
Obox3	RKERTVYSKEQQCLLQKHFDEFQYPNEKKIVELALSVGVTKREIKIWFKNNRAKYRR
Obox5	RKERTVYTKEQQRLLQKHFDECQYPNEKKIMELAVSVGVTKMEIKIWFKNNRAKYRR
Obox6	RKIRTVYTEEQKCVLKKHFHKCTYPSREQRMALAVLVGVTANEIQIWFKNHRAKSKR
Nobox	KKTRTLYRSDQLEELERIFQEDHYPDSDKRHEISQMVGVTPQRIMVWFQNRRAKWRK
Otp	KRHRTRFTPAQLNELERSFAKTHYPDIFMREELALRIGLTESRVQVWFQNRRAKWKK
Otx1	RRERTTFTRSQLDVLEALFAKTRYPDIFMREEVALKINLPESRVQVWFKNRRAKCRQ
Otx2	RRERTTFTRAQLDVLEALFAKTRYPDIFMREEVALKINLPESRVQVWFKNRRAKCRQ
Pax4	HRNRTIFSPGQAEALEKEFQRGQYPDSVARGKLAAATSLPEDTVRVWFSNRRAKWRR
Pax6	QRNRTSFTQEQIEALEKEFERTHYPDVFARERLAAKIDLPEARIQVWFSNRRAKWRR
Pax7	RRSRTTFTAEQLEELEKAFERTHYPDIYTREELAQRTKLTEARVQVWFSNRRARWRK
Pbx1	RRKRRNFNKQATEILNEYFYSHLSNPYPSEEAKEELAKKCGITVSQVSNWFGNKRIRYKK
Phox2a	RRIRTTFTSAQLKELERVFAETHYPDIYTREELALKIDLTEARVQVWFQNRRAKFRK
Phox2b	RRIRTTFTSAQLKELERVFAETHYPDIYTREELALKIDLTEARVQVWFQNRRAKFRK
Pitx1	RRQRTHFTSQQLQELEATFQRNRYPDMSMREEIAVWTNLTEPRVRVWFKNRRAKWRK
Pitx2	RRQRTHFTSQQLQELEATFQRNRYPDMSTREEIAVWTNLTEARVRVWFKNRRAKWRK
Pitx3	RRQRTHFTSQQLQELEATFQRNRYPDMSTREEIAVWTNLTEARVRVWFKNRRAKWRK
Pknox1	KNKRGVLPKHATNVMRSWLFQHIGHPYPTEDEKKQIAAQTNLTLLQVNNWFINARRRILQ
Pknox2	KNKRGVLPKHATNIMRSWLFQHLMHPYPTEDEKRQIAAQTNLTLLQVNNWFINARRRILQ
Pou1f1	RKRRTTISVAAKDALERHFGEHSKPSSQEIMRMAEELNLEKEVVRVWFCNRRQREKR
